1111111111111111111111111111111111111111111111
1000000000000000000000000000000000000000000001
1000000000000000000000000000000000000000000001
1111111111000000000000000000000000000011111111
1000000000000000111111110000000000000010000001
1000000000000000000000000000000000000010000001
1000000000000000000000000000000000000010000001
1000000000000000000000000000000000000000000002
1000000000000000000000000000000000000000000001
1000000000000000000000000000000000000000000001
1000000000111111111111111111111111000000000001
1000000000000000000000000000000000000000000001
1111111111111111111111111111111111111111111111
