1111111111111111111111111111111111111111111111
1010001000110000100010001000100000000011111101
1000100010010110001000100010001111111000000001
1111111111011110111111111111111000000011111111
1000000000000000111100000001011011111110001111
1011111111011111000101111101000000000010100001
1000000001010100010100000101111110111110111101
1011111111010111010111110100000000000000000102
1010000001010001010100010101110111111000011101
1010111101000100010001000101000000000111110001
1010101101111111111111111111111111010100010101
1000100000000000000000000000000000010001000101
1111111111111111111111111111111111111111111111
