1111111111111111111111111111111111111111111111
1010001000110000100010001000100000000000000001
1000100010010110001000100010001111111000000002
1111111111011110111111111111111000000000000001
1000000000000000000000000001011011111110001111
1011111111000000000000000001000000000010100001
1000000001000000000000000001111110111110111101
1011111111000000000000000000000000000000000101
1010000001000000000000000001110111111100011101
1010111101000000000000000001000000000111110001
1010101101111111100000111111111111010100010101
1000100000000000000000000000000000010001000101
1111111111111111111111111111111111111111111111
